NO ./textures/north.xpm
SO ./textures/south.xpm
WE ./textures/west.xpm
EA ./textures/east.xpm

F 220,100,0
C 225,30,0

111111111111111111111111
111111000000000000000001
10000D000000000000011111
111111000000000000000001
100000111110000010101001
100000100010000000000001
100000100010000010001001
100000100010000000000001
1000001DD110000010101001
100000000000000000000001
100000000111000000000001
100000000101000000000001
1000000001D1000000000001
1000000001D1000000000001
100000000000000000000001
100000000000000000000001
11DDDD111000000000000001
110100001000000000000001
110000101000000000000001
110100001000000000000001
11D111111000000000000001
110000000N00000000000001
111111111000000000000001
111111111111111111111111